200000000000000000!
111000000000000000!
001111000000000000!
000001000000000000!
000001111111110000!
000000000000010000!
000000000000010000!
000000000000011111!
000000000000000000!
000000000000000000!