200000000000000000!
111000000111110000!
001111000100010000!
000001000100010000!
000001111100010000!
000000000000010011!
000000000000010010!
000000000000011110!
000000000000000000!
000000000000000000!