200000000000000000!
111000000000000000!
001111000000000000!
000001000000000000!
000001111110000000!
000000000010000000!
001111111110000000!
001000000000011111!
001111111111110000!
000000000000000000!