000000000000000000!
000000000011111100!
000011111110000100!
000010000000000112!
000011111110000000!
000000000010000000!
001111111110000000!
001000000000011111!
001111111111110000!
000000000000000000!